1111111111111111111111111111
1P00001000000000C100000000C1
1001001000100001010000100001
1000000000000000000000000001
1000000001000000010000100001
1001000000011100000001001001
100000000001C100000000000001
1000010000010101000000000001
1000000100010100100001000011
1010000000010101000000001001
1C000100000001000100000100E1
1111111111111111111111111111