1111111111111
1000100010001
1P101010101C1
1E100010001C1
1111111111111